1111111111111111111111111
1P000001100111110000000E1
1000001010000000100000001
1000010010000000100000001
1000111110000010000000001
1000000010001000000000001
1000000010011111100000001
1010010C00000000011110101
1010010001000001010000101
1011110100100010011110101
1010010100010100010000001
1010010100001000011110C01
1111111111111111111111111