11111111111111111111111111
10000000000C00000001001001
11000010000000100000001001
100100C000000C0000C000C001
10000111000011100111011111
110010001000C0010000000111
110000001000P0010011000001
1000C000C001110000C0001001
11110000000111001000001001
11110011100111001001001111
1C110010000000001001001111
10110000111000111000000001
11111111111111111111111111