11111111
1P000C01
1000E001
11111111
10000C01
11111111