11111111
10000C01
1000E001
10000000
11111111