11111111
10000C01
1000E001
1000001
11111111