11111111
10000C01
1000P001
10000001
11111111