11111111
10000P01
1000E001
10000001
11111111