11111111111111111111111111111
10000000000000000000000000001
1011111011000010000010000C001
10001001001001010001010000001
10001001001010001010001001001
1P0010001101000001000001010E1
11111111111111111111111111111