11111111111111111111111111111
1C000000000000000000000000001
1110010100100C001010010000001
11001001010101000100100000001
1000000000000000000000000C001
1001100C000000001100000011111
10011001001111001100010011001
1101111110111100110001C111101
11011111111111001100010111101
1P0111111111110000000000000E1
11111111111111111111111111111