11111111111111111111
1000000C000100011001
11001101000000011001
111011000011000110C1
1C100001100001000001
10100000011C00011001
10100110000110000011
1P0001100000000100E1
11111111111111111111
