11111111111111111111111111
10000000000C00000001001001
11000010000000100000001001
100100C000000C0000C000C001
10000111000011100110001001
11100111000010000110001011
1C1001110010P011111C000011
1010000010000010C011111001
10100110100000110011111001
10101110100100110011111001
20000110100100000000000001
111100101001001100011000E1
11111111111111111111111111