111111111111
1C000000P001
100E00000001
111111111111
10000000C001
111111111111