11111111
10000001
10000001
10000001
10000001
10000001
10000001
1P00C0E1
11111111