11111111
1PCE0001
11110001
11111111