11111111
10000011
10000011
10001011
1111P111
1111C111
1001E101
11111111