11111111111111111111111111111
1000000000000000000000000C001
10111110110000100000100000001
10001001001001010001010001001
10001001001010001010001001001
1P0010001101000001000001010E1
11111111111111111111111111111