1111111111111111111111111111111111
1E000000000000000000000000000C0001
1110010100100C00101001000000010101
1100100101010100010010000000101001
1P000000000000000000000000000000C1
1111111111111111111111111111111111