11111111
1PE00001
11110001
1C0P0E01
11111111