11111111
1PE00001
11110001
1C000001
11111111