11111111
10000001
100000P1
1E000001
11111111